[title]
Welcome to the maze
[robots]
3
[map]
5 5 5 5 5 5 5 5 5 5 5 5 5 5 5 5 5 5 5 5 5 5 5 5 5 5 5 5 5 5 5 5 
5 0 0 0 0 0 0 0 0 0 0 0 0 0 0 0 0 0 0 0 0 0 0 0 0 0 0 0 0 0 0 5 
5 0 5 5 5 5 5 5 5 5 5 5 5 5 5 7 5 5 5 5 5 5 5 5 5 5 5 5 5 5 0 5 
5 0 5 0 0 0 0 0 0 0 0 0 0 0 0 0 0 0 0 0 0 0 0 0 0 0 0 0 0 5 0 5 
5 0 5 0 5 5 5 5 5 5 5 5 5 5 5 0 5 5 5 5 5 5 5 5 5 5 5 5 0 5 0 5 
5 0 5 0 5 0 0 0 0 0 0 0 0 0 2 0 2 0 0 0 0 0 0 0 0 0 0 5 0 5 0 5 
5 0 5 0 5 0 0 0 0 0 0 0 0 0 2 0 2 0 0 0 0 0 0 0 0 0 0 5 0 5 0 5 
5 0 5 0 5 0 0 5 5 5 5 5 5 5 5 0 5 5 5 5 5 5 5 5 5 0 0 5 0 5 0 5 
5 0 5 0 5 0 0 5 0 0 0 0 0 0 0 0 0 0 0 0 0 0 0 0 5 0 0 5 0 5 0 5 
5 0 5 0 5 0 0 5 0 0 1 0 1 0 0 0 0 0 0 0 0 0 0 0 5 0 0 5 0 5 0 5 
5 0 5 0 5 0 0 5 0 0 0 1 0 0 0 0 0 0 0 0 0 0 0 0 5 0 0 5 0 5 0 5 
5 0 0 0 0 0 0 5 0 0 1 0 1 0 0 6 6 0 0 0 0 0 0 0 5 0 0 0 0 0 0 5 
5 0 5 0 5 0 0 5 0 0 0 0 0 0 0 0 0 0 0 0 0 0 0 0 5 0 0 5 0 5 0 5 
5 0 5 0 5 0 0 5 0 0 0 0 0 0 0 0 0 0 0 0 0 0 0 0 5 0 0 5 0 5 0 5 
5 0 5 0 5 0 0 5 0 0 0 0 0 0 0 0 0 0 0 0 0 0 0 0 5 0 0 5 0 5 0 5 
5 0 5 0 5 0 0 5 0 0 0 0 0 0 0 0 0 0 0 0 0 0 0 0 5 0 0 5 0 5 0 5 
5 0 5 0 5 0 0 5 5 5 5 5 5 5 5 0 5 5 5 5 5 5 5 5 5 0 0 5 0 5 0 5  
5 0 5 0 5 0 0 0 0 0 0 0 0 0 2 0 2 0 0 0 0 0 0 0 0 0 0 5 0 5 0 5 
5 0 5 0 5 0 0 0 0 0 0 0 0 0 2 0 2 0 0 0 0 0 0 0 0 0 0 5 0 5 0 5 
5 0 5 0 5 5 5 5 5 5 5 5 5 5 5 0 5 5 5 5 5 5 5 5 5 5 5 5 0 5 0 5 
5 0 5 0 0 0 0 0 0 0 0 0 0 0 0 0 0 0 0 0 0 0 0 0 0 0 0 0 0 5 0 5 
5 0 5 5 5 5 5 5 5 5 5 5 5 5 5 0 5 5 5 5 5 5 5 5 5 5 5 5 5 5 0 5 
5 0 0 0 0 0 0 0 0 0 0 0 0 0 0 0 0 0 0 0 0 0 0 0 0 0 0 0 0 0 0 5 
5 5 5 5 5 5 5 5 5 5 5 5 5 5 5 5 5 5 5 5 5 5 5 5 5 5 5 5 5 5 5 5 