[title]
Don't worry
[robots]
2
[map]
5 5 5 5 5 5 5 5 5 5 5 5 5 5 5 5 5 5 5 5 5 5 5 5 5 5 5 5 5 5 5 5 
5 0 0 0 0 5 0 0 0 0 3 6 5 0 0 0 0 0 5 0 0 0 0 0 0 0 0 0 0 0 0 5 
5 0 0 2 0 2 0 2 0 0 0 0 2 0 0 0 0 0 5 0 0 2 0 0 2 0 0 2 0 0 0 5 
5 0 0 2 0 2 0 2 0 0 0 0 2 0 0 0 0 0 5 0 1 2 0 1 2 0 1 2 0 1 0 5 
5 0 0 0 0 5 0 0 0 0 3 6 5 0 0 0 0 0 5 0 0 2 0 0 2 0 0 2 0 0 0 5 
5 5 2 2 5 5 5 5 5 5 5 5 5 5 5 5 0 0 5 0 0 2 0 0 2 0 0 2 0 0 0 5 
5 0 0 0 0 0 0 0 0 0 0 0 0 0 0 5 0 0 5 0 0 2 0 0 2 0 0 2 0 0 0 5 
5 0 0 0 0 5 5 5 5 5 5 5 5 5 0 5 0 0 5 0 0 2 0 0 2 0 0 2 0 0 0 5 
5 2 2 2 2 5 0 0 0 0 0 0 0 5 0 5 0 0 5 0 1 2 0 1 2 0 1 2 0 1 0 5 
5 0 0 0 0 5 0 0 0 0 0 0 0 0 2 2 0 0 5 0 0 2 0 0 2 0 0 2 0 0 0 5 
5 0 0 0 0 5 0 0 0 0 0 0 0 0 2 0 2 0 5 0 0 0 0 0 0 0 0 0 0 0 0 5 
5 5 8 5 5 5 0 5 5 5 5 5 5 5 5 5 5 5 5 5 5 5 5 5 5 5 5 5 5 5 5 5 
5 0 0 0 0 5 2 2 5 6 6 6 6 5 6 6 6 6 5 6 6 6 6 5 6 6 6 6 5 0 0 5 
5 0 0 0 0 5 0 0 5 0 0 0 0 5 0 0 0 0 5 0 0 0 0 5 0 0 0 0 5 0 0 5 
5 0 0 0 0 5 0 0 5 0 0 0 0 5 0 0 0 0 5 0 0 0 0 5 0 0 0 0 5 0 0 5 
5 0 0 0 0 5 2 2 5 3 3 3 3 5 3 3 3 3 5 3 3 3 3 5 3 3 3 3 5 0 0 5 
5 0 7 0 0 5 0 0 5 0 0 0 0 5 0 0 0 0 5 0 0 0 0 5 0 0 0 0 5 0 0 5 
5 0 0 0 0 8 2 0 5 0 0 0 0 5 0 0 0 0 5 0 0 0 0 5 0 0 0 0 5 0 0 5 
5 0 0 0 0 5 0 0 5 0 0 0 0 5 0 0 0 0 5 0 0 0 0 5 0 0 0 0 5 0 0 5 
5 0 0 0 0 5 2 2 5 0 0 0 0 5 0 0 0 0 5 0 0 0 0 5 0 0 0 0 5 0 0 5 
5 0 0 0 0 5 0 0 8 0 0 0 0 5 0 0 0 0 8 0 0 0 0 8 0 0 0 0 8 0 0 5 
5 0 0 0 0 5 0 0 5 0 0 0 0 5 0 0 0 0 5 0 0 0 0 5 0 0 0 0 5 0 0 5 
5 0 0 0 0 5 2 2 5 0 0 0 0 5 0 0 0 0 5 0 0 0 0 5 0 0 0 0 5 7 7 5 
5 5 5 5 5 5 5 5 5 5 5 5 5 5 5 5 5 5 5 5 5 5 5 5 5 5 5 5 5 5 5 5 