5 5 5 5 5 5 5 5 5 5 5 5 5 5 5 5 5 5 5 5 5 5 5 5 5 5 5 5 5 5 5 5 
5 0 5 8 8 8 8 8 5 8 8 8 8 8 8 5 5 5 5 5 5 5 5 5 5 5 5 5 5 5 5 5 
5 0 5 5 5 5 5 8 5 5 8 5 8 5 5 5 5 5 5 5 5 5 5 5 5 5 5 5 5 5 5 5 
5 0 8 8 8 8 8 0 0 5 8 5 8 5 5 5 5 5 5 5 5 5 5 5 5 5 5 5 5 5 5 5 
5 5 5 5 5 5 5 5 8 5 8 5 8 5 5 5 5 5 5 5 5 5 5 5 5 5 5 5 5 5 5 5 
5 0 8 8 8 8 8 5 0 8 8 5 8 5 5 5 5 5 5 5 5 5 5 5 5 5 5 5 5 5 5 5 
5 0 5 5 5 5 5 5 8 5 5 5 8 5 5 5 5 5 5 5 5 5 8 5 5 5 5 5 0 0 0 5 
5 0 8 8 8 8 8 8 8 5 8 8 8 5 5 5 5 5 5 5 5 5 8 5 5 5 5 5 8 5 8 5 
5 8 5 5 5 5 5 5 5 5 5 5 8 5 5 5 5 5 5 5 5 5 8 5 5 5 5 5 8 5 8 5 
5 8 5 5 5 5 5 5 5 5 5 5 8 5 5 5 5 5 5 5 5 5 8 8 8 0 0 8 8 5 8 5 
5 8 8 8 8 8 8 8 8 8 8 8 8 5 8 5 5 5 5 5 5 5 8 5 5 5 8 5 5 5 8 5 
5 5 5 5 5 5 8 5 5 5 5 5 5 5 0 0 8 8 8 8 8 8 8 5 5 5 8 5 8 0 0 5 
5 5 5 5 5 5 8 5 8 8 8 8 8 8 0 0 5 5 5 8 5 5 5 5 5 5 8 5 5 5 5 5 
5 5 5 5 5 5 8 5 5 5 5 5 5 5 5 5 5 8 8 8 5 5 5 5 5 5 8 5 5 5 5 5 
5 5 5 5 5 5 0 0 8 8 8 8 8 8 8 8 8 8 5 8 5 5 7 0 0 0 2 0 0 0 6 5 
5 5 5 5 5 5 8 5 5 5 5 5 5 5 5 5 5 5 5 8 5 5 0 0 0 0 0 0 0 0 0 5 
5 5 5 5 5 5 8 5 5 5 5 5 5 5 5 5 5 5 5 8 5 5 0 0 0 0 0 0 0 0 0 5 
5 5 5 5 5 5 8 5 5 5 5 5 5 5 5 5 5 5 8 8 5 5 0 0 0 0 0 0 0 0 0 5 
5 5 5 5 5 5 8 5 5 5 5 5 5 5 5 5 5 5 8 5 5 5 0 0 0 0 1 0 0 0 0 5 
5 5 5 5 5 5 5 5 5 5 5 5 5 5 5 5 5 5 8 8 5 5 0 0 0 0 0 0 0 0 0 5 
5 5 5 5 5 5 5 5 5 5 5 5 5 5 5 5 5 5 5 8 5 5 0 0 0 0 0 0 0 0 0 5 
5 5 5 5 5 5 5 5 5 5 5 5 5 5 5 5 5 5 0 8 5 5 0 0 0 0 0 0 0 0 0 5 
5 5 5 5 5 5 5 5 5 5 5 5 5 5 5 5 5 5 0 5 5 5 0 0 0 0 0 0 0 0 0 5 
5 5 5 5 5 5 5 5 5 5 5 5 5 5 5 5 5 5 5 5 5 5 5 5 5 5 5 5 5 5 5 5 