[title]
Hoarder
[robots]
0
[map]
5 5 5 5 5 5 5 5 5 5 5 5 5 5 5 5 5 5 5 5 5 5 5 5 5 5 5 5 5 5 5 5 
5 0 2 0 0 5 0 2 0 0 0 0 2 0 0 2 0 1 0 2 5 0 0 0 2 2 0 0 2 0 1 5 
5 2 2 0 0 2 0 2 0 2 0 2 2 2 0 5 0 0 2 0 2 0 2 0 0 0 0 0 2 0 0 5 
5 0 0 0 2 0 0 2 0 0 5 0 0 2 0 0 2 2 0 0 0 5 0 0 5 0 2 2 0 2 0 5 
5 0 0 2 5 0 2 1 2 2 0 0 2 0 2 0 0 5 0 2 0 2 0 2 0 2 0 0 0 2 0 5 
5 2 2 0 0 0 2 0 5 0 0 2 2 5 0 2 0 0 1 0 0 2 2 0 0 2 0 2 2 0 0 5 
5 0 0 0 2 2 0 2 0 2 0 1 2 0 0 0 2 0 2 0 2 0 0 2 0 2 2 0 2 0 0 5 
5 0 2 0 5 0 0 2 0 0 2 0 0 2 0 0 2 2 2 0 5 0 0 2 2 0 5 0 0 2 5 5 
5 5 0 1 0 0 2 0 0 2 0 5 0 2 2 0 0 0 2 0 0 2 0 0 2 0 0 0 1 0 0 5 
5 0 2 2 0 0 5 0 2 0 0 2 0 0 0 2 0 5 0 2 2 0 0 2 0 0 0 2 2 0 0 5 
5 0 0 0 0 2 0 0 0 2 0 0 0 2 5 0 2 0 0 0 0 2 2 0 0 2 0 0 2 1 0 5 
5 2 0 5 2 0 2 0 5 0 2 5 0 0 2 2 0 2 2 0 2 0 2 0 5 0 0 2 0 2 2 5 
5 0 0 0 0 2 0 2 0 0 2 0 0 2 2 2 0 0 2 0 5 0 0 0 0 2 0 0 0 2 2 5 
5 0 2 0 0 0 0 2 0 0 2 2 2 0 0 0 0 2 0 0 0 2 0 2 2 0 0 2 0 0 0 5 
5 0 0 2 0 5 2 0 2 2 0 0 0 0 2 5 1 0 2 2 2 0 0 2 2 0 2 0 2 0 2 5 
5 2 0 0 2 0 0 0 2 2 0 5 2 0 2 2 2 0 0 2 0 0 2 0 0 2 0 0 0 2 0 5 
5 0 5 0 2 2 2 0 0 0 2 0 0 2 2 0 0 2 0 0 2 0 0 0 2 2 5 0 2 0 0 5 
5 0 2 0 0 0 0 5 2 2 0 0 2 0 2 1 0 5 2 0 2 2 5 0 0 2 0 0 0 2 0 5 
5 0 0 2 2 5 0 0 2 0 2 0 5 0 0 0 2 0 2 2 0 0 2 0 2 0 0 2 2 2 5 5 
5 5 0 2 0 2 0 2 2 0 0 2 2 0 2 0 2 0 2 0 2 2 0 2 0 2 0 2 2 0 0 5 
5 0 0 2 0 0 2 0 0 5 0 0 2 0 0 2 0 0 5 0 0 2 0 2 0 5 0 0 0 1 0 5 
5 0 2 2 0 2 0 2 0 0 0 2 0 0 5 0 0 2 2 0 1 0 5 2 0 2 0 2 0 2 7 5 
5 1 0 0 5 0 0 0 2 0 2 0 0 0 0 2 0 0 2 2 0 0 2 0 2 0 0 2 0 0 0 5 
5 5 5 5 5 5 5 5 5 5 5 5 5 5 5 5 5 5 5 5 5 5 5 5 5 5 5 5 5 5 5 5 